{
    "tiles" : [[0,  0,  0,  0,  0,  7,  7,  7,  5,  7],
               [0,  0,  0,  7,  0,  5,  5,  5,  5,  0],
               [0,  3,  0,  0,  8,  5,  0,  0,  0,  0],
               [8,  1,  0,  1,  1,  6,  1,  1,  7,  7],
               [0,  1, 99,  1, 99,  5,  99,  1,  4,  0],
               [0,  1, 99,  1, 99,  5,  0,  1,  1,  8],
               [0,  1, 99,  1, 99,  5,  7,  99,  1,  0],
               [8,  1,  1,  1,  4,  5,  7,  7,  1,  0],
               [0,  7,  7,  7,  7,  5,  9,  7,  2,  7],
               [7,  7,  7,  7,  7,  5,  7,  7,  7,  7]],
    
    "waves": [
                {
                    "knights" : 2,
                    "dwarfs" : 2,
                    "undeads" : 0
                },
                {
                    "knights" : 10,
                    "dwarfs" : 10,
                    "undeads" : 5
                }
            ]
}
