{
    "tiles" : [[7,  7,  0,  0,  0,  7,  7,  7,  5,  7],
               [7,  4,  99,  99,  0,  8,  7,  7,  5,  7],
               [7,  0,  1,  1,  1,  1,  1,  1,  1,  7],
               [0,  99,  1,  99,  0, 99,  7,  99,  1,  7],
               [5,  5,  6,  5,  5,  5,  5,  5,  6,  5],
               [0,  7,  1,  8,  0,  99,  7,  7,  1,  7],
               [0,  0,  3,  7,  7,  7,  8,  4,  1,  7],
               [7,  7,  7,  7,  7,  7,  7,  7,  1,  7],
               [0,  7,  7,  8,  0,  7,  7,  7,  2,  7],
               [0,  0,  0,  0,  0,  7,  7,  7,  7,  7]],
    
    "waves": [
                {
                    "knights" : 0,
                    "dwarfs" : 20,
                    "undeads" : 0
                },
                {
                    "knights" : 0,
                    "dwarfs" : 10,
                    "undeads" : 15
                }
            ]
}
